&(     (  %   (
     (     ( & 
          (   (
 %  & %        
  (         $  
   &    (&  && 
      & &      
          (   &
  (     % ((% '
(        %     
    & &    (A  
(          % ( 
   & &   ( (   
 % &     &(    
  & ( &    &(&%
