  $        ' ' 
''             
        %  $  $
    (       $ %
% $'    &$  %$'
 '  '          
$'     %   %  )
 '   $  $   %  
% '  %       % 
    $    $     
 %   %     %   
'      '  $'  %
$          $   
  A '        % 
         $   $ 
