     $ $  (    
((  $(    (    
 '  * &    '   
    $      $ A 
    (  *    (($
   %          *
 $$$      *    
 (   )$   $    
$$(  $$   ()   
  '  $* ' *   *
  *   ' $  $  $
 (     $$  $ )$
$   '     $ '  
               
         $     
