 )$'$ $* )     
 $     & ) $ ) 
     '   $    &
 $ $           
    &         )
     &  )   & &
  '  &        $
(      (  ($ ) 
      $'&$    &
   )     $  $ &
   $ &  ' $) ) 
      $$     )$
  ' & $ $ A   $
$  $ )     )   
    %  ) &    '
