   *    '    * 
             $ 
 ' )  )*    *  
    ))      )) 
    )   *      
    %     )*   
 *  *)  )  ( * 
  )  )        )
    '   *      
 &  '    )     
 ) * *     )  '
**     *  *    
A   )    *     
 *  *  *       
*  )         * 
