 (  $     (   $
 '   $   $%   (
    % ('& )  ( 
% $ && '     &'
 &  (  &  %   $
'  %% '    &'%%
  '' $   %%   (
   %&    '% $$ 
( (   $ (%  '% 
   (  $ %     '
   %%    %  % (
  ' % % $  ' % 
    '  $ &  ' A
   %    %      
 ( &&  '   %%  
