%&    %       $
  &           %
$        % & % 
$   %&$ $% $ & 
   $      %   $
 %             
 %&$   % $    %
$ &%       $   
%   %%  % &$%  
$'      $      
         %&    
A   $%         
  $ % $  $$  % 
% &   $   %  $ 
    $    % $%  
