%   &  & %%&  )
    ' (     %  
((   &   '    (
  '  (%      ) 
   (%    %   ' 
A'%     %%   &%
 %   (  %   '  
    % % %    % 
              &
 %         $   
%     (& (   % 
 % &  ((&     '
( & %     (    
    ( %&     & 
      %  (     
