 )(( $(  $' $  
' ( '   )$('  )
         (     
$( )         $ 
    )('     ($ 
 (  (   ' $  $'
 $ (           
 % (  &    $)  
      )(   (   
) (  $$$   $   
 ' $)*       ($
   )  (  $$ ($ 
$ )  ''  ()(  (
'  $     ( (  A
       '     ((
