         *     
$ *    *     & 
   %  *)  %    
*      %    )' 
 ) $      $   %
% *$ )) *  )  $
    $ **   **% 
 *$  *   $     
))*       ) A  
*  )     )     
* ) )%  $  *   
             % 
 $ )  )   ) $  
    (    **  * 
) *     $ *   $
