   &         %%
     '(        
    %$      %  
  &  %  '   %  
     '  & &    
 '       ( ((  
           ' ( 
A%         (   
          (  ' 
    ( (    (%  
  %   (    &%  
            ( &
     &%       %
 '      &     (
     %  &'  % '
