   ) $   $  *  
 $        $   )
   )     ) *  $
 $ $    ) $ ( )
 ))    )  $)   
    $$' ))     
$    )     $)  
  )            
   )  $( )     
 $ $)$ $ $     
               
 $$  ) $)%)  $ 
 *    )A       
   $   )   )$  
&)$   )   '    
