      &  $(    
 ( &     $     
    $   $ ( (  
     $((( $   &
' $(  (& $  &( 
   $$$ &  &  &$
    (& $   $( &
   $   &     $ 
 (    $      A 
   (  &      ( 
 &( %$  $ '   $
&   (       $  
              &
$ &   $ (( $& (
     (   (     
