    $%     ( * 
 % *   **   %  
%              
 %   **   %    
     %      %  
    %       $* 
% %            
      %%       
       %    %  
  &         A *
         '    %
%           %  
 %     )*      
      $      **
%  % %  *      
