 ) '%    %% %$(
 $  )'    )    
*    &) % (    
  %(  $    (   
  ( % )  ' $   
 )( '     $ ')$
%   %$ ( $$  )'
    $      $)  
  )     ' (   A
  ) ) $%       
 $  ) $( (  $ (
           '   
  $  (  '$   ( 
               
$    $   ( $  )
