  $         (  
 (     )'  (   
 '     (     ( 
)A)    (    (  
'( '       %   
 (            '
(   ( ( )    ) 
 &''$  $   '   
         $ ( ' 
    (    ' ''  
   )    (      
   ((  $     ( 
(   (  )  )    
 $(     )   (  
)(    *    (   
