&             $
 &        $   $
         &     
 &     $  &    
   $     $ $  '
   $         & 
$             A
  &          & 
   $      $  & 
               
      &        
$     $   % $  
     &$$$$&$  &
$      $    $  
               
