    %  $%   %  
 &( %  (%%$  &$
   $       (   
   $    %      
  &      (     
       %      &
   &       '%  
&$%  %     % ( 
  $           $
%A        & % %
      &      % 
 (        &  % 
           $  %
    %&       ( 
   %        % %
