 &        '   %
   &%'     '   
   & (A   & ( (
       '     ( 
     % %       
       %       
 &         ' & 
         &   % 
               
     ( % %   & 
  '  (&' '   % 
 &  &     (   &
  '   (  ('    
   &&  ($   &  
( ((        (  
