 %   (   )   & 
&  (     )  )''
&&  &(& (   )  
  (  ( &)%     
$&')           
)(&    )       
)  &   ' $     
 ) )   &(&   & 
    ' )&     & 
('  ')      ( &
           (   
     & )   &) &
       (  '  )*
       )       
       A$)&) ) 
