)   '   ))    %
    '      ')  
    '        % 
    ' '  '  %  
    )()      ' 
)    &   %   $ 
        %      
            &  
     %  ) ) % %
)      % )     
 %%%         A 
   '       '   
               
       %      %
          )    
