   '       '  '
 '  '          
 '    %%     ' 
        A  '   
   ' $     %  %
)  (   %     % 
  )         )  
%   %      (& (
               
'          )   
   %    ''  %  
'         '%   
'   %)   '    (
               
       '     ' 
