 '$  '      $  
 ''     '      
 & '           
$            & 
    '$ '       
      ''%   $ '
   $   ( '    $
        '      
    & $  &$ '  
'        $     
  &   &'   &   
 '  $       $ '
    $      &'  
    ''' $  A   
'           ' &
