       &  (    
 &'&(   (      
& %       &    
 & & %     % % 
)      &(%  (  
  &  &     ( & 
 %$  (         
 )  &&      (  
       (       
)     & &&   ( 
       & &   $%
 &             
 )    &        
    &    )   & 
  A& &&&   (   
