  )$*)   )  &  
)  * '     $   
     &*    &)  
     '  &*& %  
   &      %    
  '  && )&) '  
   )&   %A)  ))
    ''& )*   ) 
  ''& &&     ' 
 *       &  '%)
  ( )  '&& ' & 
         &    '
&    ' %&  ))  
&    &  '%   ) 
  & %   '& *&' 
