 * *      *    
    *   * $   *
*            * 
$   $ $ (    ( 
     ' '*  $ ' 
     '$ A()    
&    *        *
  $(      %* ' 
  *  *   **$$  
$*   $ * $*   '
   $$*     *  '
   * ' $'     $
   $      *    
   $*        *'
    ' *        
