  '           '
 * %%     '  % 
A     ''   '   
             ' 
  '       %  * 
$  %  ''       
 *'&    '*     
  %    *      &
' %*           
   & %* '  **  
       *'     *
 *        ( '*%
     '      *' 
&   '  &     )%
   *'    '%  ' 
