  (   (  &('  %
( (  %    (    
 (  %&    %    
   %   $       
      &% & & $ 
 &(   ((%    % 
   % $   %     
&   ((      $ $
A   ( %    ' '(
(%%          ((
%  (      % &  
 & ( (&  %  ( (
 %' %          
    %%  &(   & 
    $  (     ' 
