    & %    &$& 
    $       %  
    & $  %    $
          &$ $ 
$      $%   &  
&%     %     $ 
%     &   &    
      &        
  &      $$ &  
    %&$$       
   & $         
           %   
     A        '
   $$ $ &    &$
$    & $       
