%     $ $      
     %        %
  '      %    $
 $  $      (%  
 $ $      %    
$   $$$ %      
%  %  &  %%$   
   $%  $  $    
%%             
               
     $ %%   %  
 %             
 $         % $$
%         $  %%
%       %A%  % 
