   ( $ %   (   
  $ &          
)$     '       
 ('        (   
 (    &  )   ' 
    %         $
       $    (  
 $ $$ '    '   
 $      )$     
        (' ) ' 
 &       %     
$ $ )$     )   
$       (   $  
$              
   A$         )
