  )          ((
'  '       '   
   '       ( % 
   ('      '   
(   ''  '     &
     '      '  
    '          
  (   ' '('    
  '  A  (      
 ( '(          
$ (       '  ' 
  '          ( 
'    '         
  '   (     (( 
         '     
