 ))*  $%   $%  
 )  *      $   
$* (    ) )   *
* () %   &** % 
  $    )) *  * 
  *    % %  % %
 $%            
 )  % %*%    ) 
* *          )*
 %  $  %($$  %*
 $ $   (  (    
 ( (*   A  *   
*  )*  * %%    
')    *$       
    *  *     * 
