 &  &$  )&     
       &A &    
    % &  %     
   '       &% &
    &     %    
&   %    )     
&    & )& %    
&     )   &   &
) &           %
 %      (      
%  )    %      
  %    %   %   
 &&%    &      
   &   %    %  
 )     &  % %  
