 *   $ $ $  &  
&*& &    '     
   $ &     *&  
*        &''   
*&*&   '* $' ''
  *      $  )  
 %   *         
&       $ *$*  
 &  $ *     (&$
      *  &&    
 '      '     '
   &&&         
      '  $&    
      $'&   &  
 & * A&' '   *$
