   ( $ (( $(   
  && (&$$   $$ 
  ((   $$$  & &
  &  &      $& 
' &  $   & & $(
   & &   &$  $ 
& &)           
   % ($  (    (
               
       $ $%    
   $& $ $    $ 
(  &&  &$$  (& 
       $ &&$*  
( $          A 
 (           & 
