    '  $  &    
     &    &   &
    &'    ' &  
      & &   &  
    &    &    &
               
 &        &    
   &   ' ' ' & 
  ''  A&     ' 
  &   &        
         '    '
'   &      &  &
&& '       %   
     '     '&  
  '   '      & 
