         $     
 $ %&&       % 
 $&% %     $   
 $     $     %$
    &% & &     
  % $ %        
A      % %     
 $ &      %    
    $       $  
   &$          
 $%     $  %&% 
$  $ $ % $%&  &
   $ %%   $    
       &   $ & 
 &   $  $    $ 
