      &  (  & *
       &     ((
&(      )(    *
 *    & &  &%  
  (    &    &  
(         (    
  (&          *
    *    ( & (&
 & &(   (      
   (  & *      
 (           ' 
*( &      &    
  (  *&  $     
  (&   ( A     
 (   *   ((* &*
