)         '    
   ($    '($$  
$$   (        %
 & $           
&     $  '     
    '        $ 
       '    (  
           & ( 
$           (  
    '       (  
   $*    &  '  
       $  '   '
   '  '   A $  
(       & ' &  
$     &  (    '
