  '        '   
   $     '% $$ 
             $ 
   &'  '      '
 $ $ '  $  $$' 
$   $     (   )
 $    ' $ '$   
  '         $ $
''  $     $ '  
   $ A         
 $ ' '' '      
 '   '    $  $ 
         '  '  
$         $    
    '        ' 
