&   &%  & *'$  
         &  ) &
(  $   $   %&  
 (  $  %       
     $  ' &    
     $%   &    
               
 $ %  $   &   $
 & &         ( 
$ $ &   & (%  %
     $$&$  A&  
 $'          '%
   &   &   &  &
( & ( &&&  (   
%&  &   & ( %  
