 '             
   %$  %       
           $   
   '   $  '    
' $       %    
               
  '           %
  '  &        %
      '   &  $ 
     $      &  
    ' '  ''A % 
           '   
  '      &     
     '     ' ' 
    ' ''& ' ' '
